########
#X    O#
#      #
#   PX #
#      #
########